3333333333333333333333333333
0000000000000000000000000003
0000000000000033330000000000
0000000000000033330000000003
0000000000000033330000000000
0000000000000000000000000003
0000000000000000003333000000
0000000000000000003333000003
0000000000000000003333000000
0000000000000000000000000003
0000000000000033330000000000
0000000000000033330000000003
0000000000000033330000000000
0000000000000000000000000003
0000000000000000003333000000
0000000000000000003333000003
0000000000000000003333000000
0000000000000000000000000003
0000000000000033330000000000
0000000000000033330000000003
0000000000000033330000000000
0000000000000000000000000003
0000000000000000003333000000
0000000000000000003333000003
0000000000000000003333000000
0000000000000000000000000003
0000000000000000000000000000
0000000000000000000000000003
3333333333333333333333333333